Player,Ally Code,Starting Gear Needed,Progress,Current Gear Needed,Team
Qin Phfal,237375819,0,0,0,Grievous: GG B2 B1 Droideka MagnaGuard
Qin Phfal,237375819,0,0,0,Dooku+Asajj: Dooku AV
Qin Phfal,237375819,0,0,0,Geos: GBA Poggle Geo Soldier Sun Fac Geo Spy
Qin Phfal,237375819,6,1,5,Troopers: Veers Piett Gideon Dark Trooper Range Trooper G7
BearLee,387139863,0,0,0,Grievous: GG B2 B1 Droideka MagnaGuard
BearLee,387139863,0,0,0,Dooku+Asajj: Dooku AV
BearLee,387139863,0,0,0,Geos: GBA Poggle Geo Soldier Sun Fac Geo Spy
BearLee,387139863,3,0,3,Troopers: Veers Piett Starck Dark Trooper Range Trooper G9
Q92,261337715,12,12,0,Grievous: GG B2 B1 Droideka MagnaGuard
Q92,261337715,5,2,3,Troopers: Veers G11 Piett Gideon G11 Dark Trooper Range Trooper G11
Q92,261337715,0,0,0,Geos: GBA Poggle Geo Soldier Sun Fac Geo Spy
Q92,261337715,2,1,1,Dooku+Asajj: Dooku G11 AV
Azza 2017,525689438,1,1,0,Troopers: Veers Piett Gideon Dark Trooper Range Trooper
Azza 2017,525689438,1,1,0,Grievous: GG B2 B1 Droideka MagnaGuard
Azza 2017,525689438,1,1,0,Dooku+Asajj: Dooku AV
Azza 2017,525689438,0,0,0,Geos: GBA Poggle Geo Soldier Sun Fac Geo Spy
Vaha68,517167991,0,0,0,Grievous: GG B2 B1 Droideka MagnaGuard
Vaha68,517167991,0,0,0,Dooku+Asajj: Dooku AV
Vaha68,517167991,0,0,0,Geos: GBA Poggle Geo Soldier Sun Fac Geo Spy
Vaha68,517167991,14,5,9,Troopers: Veers Piett Starck Dark Trooper G7 5* Range Trooper G8 5*
skull crusher,776436941,0,0,0,Grievous: GG B2 B1 Droideka MagnaGuard
skull crusher,776436941,1,0,1,Dooku+Asajj: Dooku G11 AV
skull crusher,776436941,5,0,5,Geos: GBA G11 Poggle G11 Geo Soldier G11 Sun Fac G11 Geo Spy G11
Mo Yin,524533215,7,7,0,Troopers: Veers Piett Gideon Dark Trooper Range Trooper
Mo Yin,524533215,0,0,0,Grievous: GG B2 B1 Nute MagnaGuard
Mo Yin,524533215,0,0,0,Dooku+Asajj: Dooku AV
Mo Yin,524533215,0,0,0,Geos: GBA Poggle Geo Soldier Sun Fac Geo Spy
Neko,449267729,0,0,0,Troopers: Veers Piett Gideon Dark Trooper Range Trooper
Neko,449267729,20,20,0,Grievous: GG B2 B1 Droideka MagnaGuard
Neko,449267729,0,0,0,Geos: GBA Poggle Geo Soldier Sun Fac Geo Spy
Neko,449267729,7,5,2,Dooku+Asajj: Dooku AV G10
Chirrut Îmwe,592673129,0,0,0,Grievous: GG B2 B1 Droideka MagnaGuard
Chirrut Îmwe,592673129,0,0,0,Dooku+Asajj: Dooku AV
Chirrut Îmwe,592673129,0,0,0,Geos: GBA Poggle Geo Soldier Sun Fac Geo Spy
Chirrut Îmwe,592673129,6,2,4,Troopers: Veers Piett Starck Dark Trooper G11 6* Range Trooper G9 6*
Daadcity,444374162,0,0,0,Geos: GBA Poggle Geo Soldier Sun Fac Geo Spy
Daadcity,444374162,3,0,3,Grievous: GG G9 B2 B1 Droideka MagnaGuard
Daadcity,444374162,7,0,7,Dooku+Asajj: Dooku G5 AV
乂ιρ,691737775,1,0,1,Grievous: GG B2 B1 Nute G11 MagnaGuard
乂ιρ,691737775,0,0,0,Dooku+Asajj: Dooku AV
乂ιρ,691737775,0,0,0,Geos: GBA Poggle Geo Soldier Sun Fac Geo Spy
乂ιρ,691737775,1,0,1,Troopers: Veers Piett Starck Dark Trooper G11 6* Range Trooper
Rellik,484158711,0,0,0,Grievous: GG B2 B1 Droideka MagnaGuard
Rellik,484158711,0,0,0,Dooku+Asajj: Dooku AV
Rellik,484158711,0,0,0,Geos: GBA Poggle Geo Soldier Sun Fac Geo Spy
Rellik,484158711,17,5,12,Troopers: Veers Piett G9 5* Gideon G11 Dark Trooper G9 5* Range Trooper G7 6*
Diath,858559118,10,10,0,Troopers: Veers Piett Starck Dark Trooper Range Trooper
Diath,858559118,0,0,0,Grievous: GG B2 B1 Nute MagnaGuard
Diath,858559118,0,0,0,Dooku+Asajj: Dooku AV
Diath,858559118,0,0,0,Geos: GBA Poggle Geo Soldier Sun Fac Geo Spy
Inquísìtor Strize,486434149,3,1,2,Grievous: GG B2 G10 B1 Droideka MagnaGuard
Inquísìtor Strize,486434149,6,1,5,Dooku+Asajj: Dooku G8 AV G11
Inquísìtor Strize,486434149,1,0,1,Geos: GBA Poggle G11 Geo Soldier Sun Fac Geo Spy
BabyGoat851,996376328,1,1,0,Grievous: GG B2 B1 Droideka MagnaGuard
BabyGoat851,996376328,3,3,0,Dooku+Asajj: Dooku AV
BabyGoat851,996376328,0,0,0,Geos: GBA Poggle Geo Soldier Sun Fac Geo Spy
Texte239,847319871,0,0,0,Dooku+Asajj: Dooku AV
Texte239,847319871,0,0,0,Geos: GBA Poggle Geo Soldier Sun Fac Geo Spy
Texte239,847319871,4,4,0,Grievous: GG B2 B1 Droideka MagnaGuard
R2D2,889324759,0,0,0,Grievous: GG B2 B1 Droideka MagnaGuard
R2D2,889324759,0,0,0,Dooku+Asajj: Dooku AV
R2D2,889324759,0,0,0,Geos: GBA Poggle Geo Soldier Sun Fac Geo Spy
R2D2,889324759,12,5,7,Troopers: Veers Piett Starck Dark Trooper G9 Range Trooper G8
Ralthor,639153363,0,0,0,Grievous: GG B2 B1 Droideka MagnaGuard
Ralthor,639153363,0,0,0,Dooku+Asajj: Dooku AV
Ralthor,639153363,0,0,0,Geos: GBA Poggle Geo Soldier Sun Fac Geo Spy
Bearzerker,224595239,0,0,0,Troopers: Veers Piett Gideon Dark Trooper Range Trooper
Bearzerker,224595239,8,8,0,Grievous: GG B2 B1 Nute MagnaGuard
Bearzerker,224595239,0,0,0,Geos: GBA Poggle Geo Soldier Sun Fac Geo Spy
Bearzerker,224595239,0,0,0,Dooku+Asajj: Dooku AV
Dhsk,466455974,0,0,0,Geos: GBA Poggle Geo Soldier Sun Fac Geo Spy
Dhsk,466455974,11,3,8,Dooku+Asajj: Dooku G9 AV G7
DarthSinister,787198725,0,0,0,Grievous: GG B2 B1 Droideka MagnaGuard
DarthSinister,787198725,0,0,0,Dooku+Asajj: Dooku AV
DarthSinister,787198725,0,0,0,Geos: GBA Poggle Geo Soldier Sun Fac Geo Spy
DarthSinister,787198725,13,4,9,Troopers: Veers Piett Starck Dark Trooper G7 5* Range Trooper G8
Orion,951862265,0,0,0,Grievous: GG B2 B1 Droideka MagnaGuard
Orion,951862265,0,0,0,Dooku+Asajj: Dooku AV
Orion,951862265,0,0,0,Geos: GBA Poggle Geo Soldier Sun Fac Geo Spy
Orion,951862265,20,15,5,Troopers: Veers Piett Starck Dark Trooper G9 5* Range Trooper G10
Zack,426488714,3,0,3,Grievous: GG B2 G10 B1 Nute G11 MagnaGuard
Zack,426488714,0,0,0,Geos: GBA Poggle Geo Soldier Sun Fac Geo Spy
Zack,426488714,9,1,8,Troopers: Veers G11 Piett Gideon G9 Dark Trooper G11 6* Range Trooper G9
Zack,426488714,2,0,2,Dooku+Asajj: Dooku G10 AV
Blp2401,795254344,0,0,0,Grievous: GG B2 B1 Droideka MagnaGuard
Blp2401,795254344,0,0,0,Geos: GBA Poggle Geo Soldier Sun Fac Geo Spy
Blp2401,795254344,16,5,11,Troopers: Veers G10 6* Piett Gideon G9 5* Dark Trooper G11 5* Range Trooper G7 4*
Blp2401,795254344,2,1,1,Dooku+Asajj: Dooku G11 AV
KoninginKonan,968292886,11,11,0,Troopers: Veers Piett Starck Dark Trooper Range Trooper
KoninginKonan,968292886,0,0,0,Grievous: GG B2 B1 Droideka MagnaGuard
KoninginKonan,968292886,0,0,0,Dooku+Asajj: Dooku AV
KoninginKonan,968292886,1,1,0,Geos: GBA Poggle Geo Soldier Sun Fac Geo Spy
Ωhme,449894731,2,2,0,Grievous: GG B2 B1 Droideka MagnaGuard
Ωhme,449894731,6,6,0,Dooku+Asajj: Dooku AV
Serpens,645725141,2,2,0,Grievous: GG B2 B1 Droideka MagnaGuard
Serpens,645725141,0,0,0,Dooku+Asajj: Dooku AV
Serpens,645725141,0,0,0,Geos: GBA Poggle Geo Soldier Sun Fac Geo Spy
Serpens,645725141,20,1,19,Troopers: Veers G10 Piett G9 Starck G8 Dark Trooper G7 5* Range Trooper G7 5*
Pommy,142277723,0,0,0,Grievous: GG B2 B1 Droideka MagnaGuard
Pommy,142277723,1,1,0,Dooku+Asajj: Dooku AV
Pommy,142277723,4,4,0,Geos: GBA Poggle Geo Soldier Sun Fac Geo Spy
Pommy,142277723,12,7,5,Troopers: Veers G11 Piett Starck G11 Dark Trooper Range Trooper G9
Ghost Nappa,365784761,0,0,0,Dooku+Asajj: Dooku AV
Ghost Nappa,365784761,0,0,0,Geos: GBA Poggle Geo Soldier Sun Fac Geo Spy
Ghost Nappa,365784761,8,8,0,Grievous: GG B2 B1 Droideka MagnaGuard
Macvidar92,295681967,7,6,1,Grievous: GG B2 B1 Droideka G11 MagnaGuard
Macvidar92,295681967,0,0,0,Geos: GBA Poggle Geo Soldier Sun Fac Geo Spy
Macvidar92,295681967,4,0,4,Dooku+Asajj: Dooku G11 AV G9
Jason,467564358,0,0,0,Grievous: GG B2 B1 Nute MagnaGuard
Jason,467564358,0,0,0,Dooku+Asajj: Dooku AV
Jason,467564358,10,1,9,Troopers: Veers Piett Starck Dark Trooper G5 Range Trooper G10
Jason,467564358,5,4,1,Geos: GBA Poggle Geo Soldier Sun Fac Geo Spy G11
jhitt7,612627154,0,0,0,Grievous: GG B2 B1 Droideka MagnaGuard
jhitt7,612627154,0,0,0,Geos: GBA Poggle Geo Soldier Sun Fac Geo Spy
jhitt7,612627154,4,0,4,Dooku+Asajj: Dooku G8 AV
MaxRanavan,121954532,0,0,0,Troopers: Veers Piett Gideon Dark Trooper Range Trooper
MaxRanavan,121954532,0,0,0,Dooku+Asajj: Dooku AV
MaxRanavan,121954532,0,0,0,Geos: GBA Poggle Geo Soldier Sun Fac Geo Spy
DeputyDan,719787543,0,0,0,Troopers: Veers Piett Starck Dark Trooper Range Trooper
DeputyDan,719787543,0,0,0,Grievous: GG B2 B1 Droideka MagnaGuard
DeputyDan,719787543,0,0,0,Dooku+Asajj: Dooku AV
DeputyDan,719787543,0,0,0,Geos: GBA Poggle Geo Soldier Sun Fac Geo Spy
Jameson,922247616,0,0,0,Troopers: Veers Piett Starck Dark Trooper Range Trooper
Jameson,922247616,7,7,0,Grievous: GG B2 B1 Droideka MagnaGuard
Jameson,922247616,0,0,0,Geos: GBA Poggle Geo Soldier Sun Fac Geo Spy
Jameson,922247616,1,0,1,Dooku+Asajj: Dooku AV G11
Dexter,259247871,3,3,0,Troopers: Veers Piett Gideon Dark Trooper Range Trooper
Dexter,259247871,0,0,0,Grievous: GG B2 B1 Droideka MagnaGuard
Dexter,259247871,0,0,0,Dooku+Asajj: Dooku AV
Dexter,259247871,0,0,0,Geos: GBA Poggle Geo Soldier Sun Fac Geo Spy
Bruhmoment,185679354,3,3,0,Grievous: GG B2 B1 Nute MagnaGuard
Bruhmoment,185679354,0,0,0,Dooku+Asajj: Dooku AV
Connor,287586656,0,0,0,Grievous: GG B2 B1 Droideka MagnaGuard
Connor,287586656,0,0,0,Geos: GBA Poggle Geo Soldier Sun Fac Geo Spy
Connor,287586656,4,0,4,Dooku+Asajj: Dooku G8 AV
swine destroyer,938382827,0,0,0,Dooku+Asajj: Dooku AV
swine destroyer,938382827,0,0,0,Geos: GBA Poggle Geo Soldier Sun Fac Geo Spy
JohnnyUtah,454898459,0,0,0,Troopers: Veers Piett Gideon Dark Trooper Range Trooper
JohnnyUtah,454898459,1,0,1,Grievous: GG B2 G11 B1 Droideka MagnaGuard
JohnnyUtah,454898459,0,0,0,Dooku+Asajj: Dooku AV
JohnnyUtah,454898459,0,0,0,Geos: GBA Poggle Geo Soldier Sun Fac Geo Spy
Bigs Little,617228366,11,1,10,Grievous: GG B2 G8 B1 Droideka G10 MagnaGuard G8
Bigs Little,617228366,0,0,0,Geos: GBA Poggle Geo Soldier Sun Fac Geo Spy
Bigs Little,617228366,4,0,4,Dooku+Asajj: Dooku G8 AV
xGhostCaliberx,855417377,0,0,0,Grievous: GG B2 B1 Droideka MagnaGuard
xGhostCaliberx,855417377,0,0,0,Dooku+Asajj: Dooku AV
xGhostCaliberx,855417377,0,0,0,Geos: GBA Poggle Geo Soldier Sun Fac Geo Spy
xGhostCaliberx,855417377,4,0,4,Troopers: Veers Piett Starck Dark Trooper G11 Range Trooper G9
MasterShep2,332979431,0,0,0,Grievous: GG B2 B1 Droideka MagnaGuard
MasterShep2,332979431,18,11,7,Troopers: Veers G11 Piett Starck G9 Dark Trooper Range Trooper G9
MasterShep2,332979431,3,0,3,Dooku+Asajj: Dooku G10 AV G11
MasterShep2,332979431,3,1,2,Geos: GBA Poggle G11 Geo Soldier Sun Fac G11 Geo Spy
Vel'Train,455642849,11,10,1,Troopers: Veers Piett Gideon G11 Dark Trooper Range Trooper
Vel'Train,455642849,5,0,5,Geos: GBA G9 Poggle G11 Geo Soldier Sun Fac G11 Geo Spy
Metatron72,588623761,0,0,0,Grievous: GG B2 B1 Droideka MagnaGuard
Metatron72,588623761,0,0,0,Dooku+Asajj: Dooku AV
Metatron72,588623761,0,0,0,Geos: GBA Poggle Geo Soldier Sun Fac Geo Spy
Metatron72,588623761,5,2,3,Troopers: Veers Piett Starck Dark Trooper Range Trooper G9
JRobertson12,221913824,2,2,0,Grievous: GG B2 B1 Droideka MagnaGuard
JRobertson12,221913824,0,0,0,Dooku+Asajj: Dooku AV
JRobertson12,221913824,4,0,4,Geos: GBA Poggle G11 Geo Soldier G11 Sun Fac G11 Geo Spy G11
TonkaDavid,759331513,0,0,0,Grievous: GG B2 B1 Droideka MagnaGuard
TonkaDavid,759331513,1,1,0,Dooku+Asajj: Dooku AV
TonkaDavid,759331513,7,3,4,Troopers: Veers Piett Starck Dark Trooper Range Trooper G8
TonkaDavid,759331513,16,0,16,Geos: GBA G10 Poggle G9 Geo Soldier G8 Sun Fac G8 Geo Spy G9
IceStoy,298744196,6,6,0,Grievous: GG B2 B1 Droideka MagnaGuard
IceStoy,298744196,1,1,0,Dooku+Asajj: Dooku AV
IceStoy,298744196,0,0,0,Geos: GBA Poggle Geo Soldier Sun Fac Geo Spy
WildfireX,552286427,0,0,0,Grievous: GG B2 B1 Nute MagnaGuard
WildfireX,552286427,8,8,0,Troopers: Veers Piett Gideon Dark Trooper Range Trooper
WildfireX,552286427,0,0,0,Dooku+Asajj: Dooku AV
WildfireX,552286427,0,0,0,Geos: GBA Poggle Geo Soldier Sun Fac Geo Spy
CT5555,981748341,0,0,0,Troopers: Veers Piett Gideon Dark Trooper Range Trooper
CT5555,981748341,0,0,0,Grievous: GG B2 B1 Droideka MagnaGuard
CT5555,981748341,0,0,0,Geos: GBA Poggle Geo Soldier Sun Fac Geo Spy
CT5555,981748341,7,3,4,Dooku+Asajj: Dooku G8 AV
